12 12
10 10 10 10 10 10 10 1 1 1 1 1 1 1 1 1 1 1 1 1 1 1 1 1 1
10  0  0  0  0  0  10 1 0 0 0 0 0 0 0 0 0 0 0 0 0 0 0 0 1
10  0  0  7  0  0  10 1 0 0 0 0 0 0 0 0 0 0 0 0 0 0 0 0 1
10  0  0  0  0  7  10 1 0 2 3 2 2 4 2 3 2 0 0 2 0 0 0 0 1
10  0  0  0  0  0  10 1 0 4 0 0 0 0 0 0 4 0 0 4 0 0 0 0 1
10  0  7  0  0  0  10 1 0 2 0 0 0 0 0 0 2 0 0 3 0 0 0 0 1
10  0  0  0  0  0  10 1 0 3 0 0 5 0 0 0 2 0 0 4 0 0 0 0 1
10  0  0  0  0  0  10 1 0 2 0 0 0 0 0 0 3 0 0 2 0 0 0 0 1
10 10  8  8 11 10  10 1 0 3 0 0 0 0 0 0 3 0 0 0 0 0 0 0 1
1  1   0  0  1  1  1  1 0 4 2 6 9 2 2 3 2 0 0 2 0 0 0 0 1
1  0   0  0  0  0  0  0 0 0 0 0 0 0 0 0 0 0 0 3 0 0 0 0 1
1  0   0  0  0  0  0  0 0 0 0 0 0 0 0 0 0 0 0 2 0 0 0 0 1
1  0   0  0  0  0  0  0 0 0 0 0 0 0 0 0 0 0 0 2 0 0 0 0 1
1  0   0  0  0  0  0  0 0 0 0 0 0 0 0 0 0 0 0 0 0 0 0 0 1
1  1   1  1  1  1  1  1 1 1 1 1 1 1 1 1 1 1 1 1 1 1 1 1 1
