12 12
1 1 1 1 1 1 1 1 1 1 1 1 1 2 2 1 1 1 1 1 1 1 1 1
1 0 0 0 0 1 0 0 0 0 0 0 0 0 0 0 0 0 0 0 0 0 0 1
1 0 0 7 0 1 0 0 0 0 0 0 0 0 0 0 0 0 0 0 0 0 0 1
1 0 0 0 0 1 0 0 2 3 2 2 4 2 3 2 0 0 2 0 0 0 0 1
1 0 0 0 0 1 0 0 4 0 0 0 0 0 0 4 0 0 4 0 0 0 0 1
1 0 0 0 0 1 0 0 2 0 0 0 0 0 0 2 0 0 3 0 0 0 0 1
1 0 7 0 0 1 0 0 3 0 0 5 0 0 0 2 0 0 4 0 0 0 0 1
1 0 0 0 0 1 0 0 2 0 0 0 0 0 0 3 0 0 2 0 0 0 0 1
1 0 0 9 1 1 0 0 3 0 0 0 0 0 0 3 0 0 0 0 0 0 0 1
1 0 0 0 0 0 0 0 4 2 4 6 9 2 3 2 0 0 2 0 0 0 0 1
1 0 0 0 0 0 0 0 0 0 0 0 0 0 0 0 0 0 3 0 0 0 0 1
1 0 0 0 0 0 0 0 0 0 0 0 0 0 0 0 0 0 2 0 0 0 0 1
1 0 0 0 0 0 0 0 0 0 0 0 0 0 0 0 0 0 2 0 0 0 0 1
1 0 0 0 0 0 0 0 0 0 0 0 0 0 0 0 0 0 0 0 0 0 0 1
1 1 1 1 1 1 1 1 1 1 1 1 1 1 1 1 1 1 1 1 1 1 1 1
